NO ./assets/bluestone.xpm
SO ./assets/wall1.xpm
WE ./assets/wall2.xpm
EA ./assets/wall3.xpm
F 220,100,0
C 225,30,0

    111111111111111111111111111111111
   10000000000000011111000000000000001
  1001111111111110011100111111111111001
 100111111111111110010011111111111111001
10011111111111111110001111111111111111001
10111111111111111110N01111111111111111101
10011111111111111110001111111111111111001
 100111111111111110010011111111111111001
  1001111111111110011100111111111111001
   10000000000000011111000000000000001
    111111111111111111111111111111111
