NO ./assets/guy.xpm
SO ./assets/wall1.xpm
WE ./assets/wall2.xpm
EA ./assets/wall3.xpm
F 220,100,0
C 225,30,0

11111111111111
10000011111001
10111000000001
10000000000001
11000110110001
11010000100111
10010W00000001
10010000000001
10011111001111
10001011000001
10110000001101
10000111110001
10000000000111
11111111111111
