SO  ./path_to_the_south_texture
EA ./path_to_the_east_texture

NO ./path_to_the_north_texture

WE ./path_to_the_west_texture
F 0,0,102



C 0,255,255

                111111
        1111111110000111111111111
        1000000000110000000000001
        1011000001110000000000001
        1001000000000000000000001
111111111011000001110000000000001
1110000001100000111111111111111111111111111
   1011111111101110000001000111111100010001
111101111111110111010100100011100000111011
11000000110101011100000010001111111111111
10000000000000001100000000001
10000000000000001101010010001
11000001110101011111011110E0111111
11110111 1110101 101111010001
11111111 1000011 111111111111
11111111 1011111 111111111111
11111111 101 111 111111111111
11111111 101 111 111111111111
11111111 111 111 111111111111
