NO ./assets/guy.xpm
SO ./assets/bluestone.xpm
WE ./assets/wall1.xpm
EA ./assets/wall2.xpm

F 0,153,76

C 0,255,255
111111111111
111111111101
100000000011
100000000011
100000000011
100000000011
10000W000011
100000000011
1000000000111
100000000011
11111111111
