NO ./assets/bluestone.xpm
SO ./assets/wall1.xpm
WE ./assets/wall2.xpm
EA ./assets/wall3.xpm
F 220,100,0
C 225,30,0

11111111111
10000000001
10000000001
10000000001
10000100001
10000000001
10000000001
10000000001
10000N00001
11111111111
