NO ./asset/32x32GreyBrickTexture-MangoPunch.png
SO ./asset/32x32GreyBrickTexture-MangoPunch.png
WE ./asset/32x32GreyBrickTexture-MangoPunch.png
EA ./asset/32x32GreyBrickTexture-MangoPunch.png
F 220,100,0
C 225,30,0

1111111111111111111111111
1000000000000000000000001
1000000000000000000000001
1000000000000000000000001
1000000000000000000000001
1000000000000000000000001
1000000000000000000000001
1000000000000000000000001
1000000000000000000000001
1000000000000000000000001
10000000000N0000000000001
1111111111111111111111111