SO ./assets/east.xpm
WE ./assets/east.xpm
NO ./assets/east.xpm
EA ./assets/east.xpm
F 220     ,          100,0
C 225,30,0

1111111111111111111111111
1000000000110000000000001
1011000001110000000000001
1001000000000000000000001
111111111011000001110000011
100000000011000001110111111111111
11110000000000000000000010001
11110111110000000000000010001
11000000100000000000000010001
1000000100000000S000000010001
10000000000000000000010010001
11000000000000111110111100111
1111011111111101 101111010001
11111111     111 111111111111
11111111 111 111 111111111111